1 1 2 1 0 2 1 1 1 2 0 0 1 0 1 
0 1 4 12 21 12 23 20 13 17 13 13 3 1 1  
1 2 16 0 0 0 0 0 0 0 0 0 10 1 0  
1 0 22 0 0 0 0 0 0 0 0 0 18 0 2  
0 1 16 0 0 24 25 0 0 0 0 0 10 1 0  
1 1 17 0 0 26 27 28 0 0 0 0 10 1 1  
1 0 20 0 0 0 29 30 31 0 0 0 20 1 1  
1 1 15 0 0 0 0 32 33 0 0 0 11 0 2  
1 0 21 0 0 0 0 0 0 0 0 0 21 0 0  
2 0 15 0 0 0 0 0 0 0 0 0 11 1 0  
2 2 15 0 0 0 0 0 0 1 0 0 11 0 0  
2 2 3 14 19 14 14 20 8 7 17 6 5 2 1 
2 2 0 0 2 2 1 0 1 1 1 1 1 2 1 