1 1 2 1 0 2 1 1 1 2 0 0 1 0 1 
0 1 4 3 0 5 6 0 7 0 0 0 3 1 1  
1 2 0 0 0 0 0 0 0 0 0 0 0 2 0  
1 0 0 0 0 0 0 0 0 0 0 0 0 0 2  
0 1 0 0 0 0 0 0 0 0 0 0 0 1 0  
1 1 0 0 0 0 0 0 0 0 0 0 0 1 1  
1 0 0 0 0 0 0 0 0 0 0 0 0 0 1  
1 1 0 0 0 0 0 0 0 0 0 0 0 2 2  
1 0 0 0 0 0 0 0 0 0 0 0 0 0 0  
2 0 0 0 0 0 0 0 0 0 0 0 0 1 0  
2 2 3 0 0 0 0 0 8 7 0 6 5 0 0  
2 2 0 0 2 2 1 0 1 1 1 1 1 2 1 